11111
1E001
10101
10011
11001
1C001
100C1
10111
10C11
110P1
10001
10111
1C111
11111
