1111111
10P0001
10E0C11
10001
1111111

