11111
1C001
10P01
10001
11111
