11111111
100C000E
10110001
10P00001
11111111
