11111111111
11111110001
11111110C01
11111110001
11111111111
1000P000111
11111C00001
11101100011
11000001111
1E001111111
11001111111
11000000011
11111111111
